#########
#p.c....#
#.#c#c#.#
#...#...#
#.##f##.#
#...#...#
#.#c#c#.#
#....c.p#
#########