#########
#p..c...#
#.#c#c#.#
#....c..#
#.#cfc#.#
#..c....#
#.#c#c#.#
#...c..p#
#########