#########
#p......#
#.#c#c#.#
#.#fcf#.#
#.#cfc#.#
#.#####.#
#......p#
#########
