#########
#f#.c.#f#
#0.cfc.1#
#f#.c.#f#
#########