#########
#p.c...f#
#.#c#c#.#
#...cfc.#
#.#cfc#.#
#.cfc...#
#.#c#c#.#
#f...c.p#
#########