#############
#p#f#f#f#f#f#
#.#f#f#f#.#.#
#.#f#f#f#.#.#
#.#.#f#.#.#.#
#.#.#f#.#.#.#
#.#.#f#.#.#.#
#.#.#f#.#.#.#
#.#.#.#.#.#.#
#.#.#.#.#.#.#
#.#.#.#.#.#.#
#.#.#.#.#.#.#
#c#.#.#.#.#.#
#cc........p#
#############
