#########
#p....cf#
#..#...c#
####c####
#..#..cc#
#p....cf#
#########
