##############################
#0............c.............1#
#.#########c#ccc#c##########.#
#.#########.#ccc#.##########.#
#.#########.#fff#.##########.#
#.#########.#fff#.##########.#
#.#########.#fff#.##########.#
#....fffccc.ccccc.cccfff.....#
##############################
