#########
#p#.....#
#.#..#..#
#.#.#.#.#
#.#.#.#.#
#.#f#.#.#
#..#..#.#
#.......#
#....#..#
#.#.#.#.#
#.#.#f#.#
#.#.#.#.#
#..#..#.#
#.....#p#
#########
