###########
#####f#####
##p......##
#f...f...f#
##......p##
#####f#####
###########