##############################
#0..........................1#
#.############.#############.#
#.#ffffffffffffffffffffffff#.#
#.#ffffffffffffffffffffffff#.#
#.#ffffffffffffffffffffffff#.#
#.##########################.#
#............................#
##############################
