#########
#f.....f#
####.####
   #.#
   #.#
   #.#
   #.#
   #.#
   #.#
####.####
#.......#
#.......#
#..p.p..#
#########