###########
#p#f#f#...#
#.#..c..cf#
#....f...##
##.##c#..p#
#####f#####
###########
