#########
#p.....f#
#..ccc..#
#.c#c#c.#
#.ccfcc.#
#.c#c#c.#
#..ccc..#
#f.....p#
#########