#########
#p.....f#
####c####
#p.....f#
#########