###########
#p#f#f#...#
#.#..c..cf#
#.c..f...##
##.##c#..p#
#####f#####
###########
