##############################
#0........c...c...c.........1#
#.#########c#####c##########.#
#.#########.#####.##########.#
#.#########.#####.##########.#
#.#########.#####.##########.#
#.#########.#####.##########.#
#....fff###.fffff.###fff.....#
##############################