#########
#p.c....#
#.#c#c#.#
#..c.cc.#
#.#c#c#.#
#.c.cc..#
#.#c#.#.#
#..ccc.p#
#########