####
#p.##
##..##
###..##
####..##
#####..##
######..##
#######c###
############