####
#p.##
##..##
###..##
####..##
#..#...##
#..#.#..##
#....##c###
############