###############
#p............#
#.#.#.#.#.#.#.#
#.............#
#.#.#.#.#.#.#.#
#.............#
#.#.#.#.#.#.#.#
#.............#
#.#.#.#.#c#.#.#
#.............#
#.#.#.#.#.#.#.#
#.............#
###############