#######
#p....#
#.#.#.#
#.....#
#.#.#.#
#....c#
#######